# Simple replace table
# Format: word=suggestion1|suggestion2|suggestion3...
# This is only for words that are not caught by spell checker
# Mainly from  https://github.com/linuxscout/aghlat

?=؟
⁇=؟؟
⁈=؟!
⁉=!؟
او=أو
اذا=إذا
الى=إلى
فى=في
هى=هي
انت=أنت
انتما=أنتما
التى=التي
الذى=الذي
مائة=مئة
المائة=المئة
يافطة=لافتة
اليافطة=اللافتة
مقفول=مقفل
مغلوق=مغلق
ثقاة=ثقات
رتوش=لمسة
الرتوش=اللمسة
تلفون=هاتف
التلفون=الهاتف
بالتلفون=بالهاتف
بتلفون=هاتف
نجاعة=نجوع
النجاعة=النجوع
ذاتا=ذواتا
أسطحة=سطوح|أسْطح
الأسطحة=السطوح|الأسْطح
أسقفة=أسقف|سقوف|سُقف
الأسقفة=الأسقف|السقوف|السُقف
أظافر=أظفار
الأظافر=الأظفار
حصوة=حصاة
الحصوة=الحصاة
الصالون=البهو|الضيافة
صالون=بهو|ضيافة
كرتون=رسوم متحركة|ورق مقوى
الكرتون=الرسوم المتحركة|الورق المقوى
موانئ=مواني
الموانئ=المواني
وريث=وارث
الوريث=الوارث
أنوية=نَوًى|نَوَيات
الأنوية=النَّوًى|النَّوَيات
تصامم=تصامّ
تطمين=طمأنة
التطمين=الطمأنة
حكايا=حكايات
الحكايا=الحكايات
خارطة=المُصوَّر|خريطة
الخارطة=المُصوَّر|الخريطة
رئيف=رؤوف
الرئيف=الرؤوف
رفاة=رفات
الرفاة=الرفات
عرايا=عريانون
العرايا=العريانون
فحوصات=فحوص
الفحوصات=الفحوص
قفازات=قفافيز
القفازات=القفافيز
كبلات=أكْبُل|كُبُول|أكبال|كِبال
الكبلات=الأكْبُل|الكُبُول|الأكبال|الكِبال
محلات=محالّ
المحلات=المحالّ
مدراء=مُديرو|مُديرون|مُديرين
المدراء=المُديرو|المُديرون|المُديرين
مندهش=دَهِش|مدهوش
المندهش=الدَهِش|المدهوش
نصوح=ناصح
النصوح=الناصح
والتي=التي
والذي=الذي
الإطلاع=الاطّلاع
إطلاع=اطّلاع
استبديت=استبدَدْتُ
استغليت=استغلَلْتُ
استقليت=استقلَلْتُ
يضطرد=يطّرد
اضطرد=يطّرد
إيلول=أيلول
عامود=عمود
عواميد=أعْمِدة|عُمُد
العامود=العمود
العواميد=الأعْمِدة|العُمُد
دافئ=دفئ|دفيء
الدافئ=الدفئ|الدفيء
قفراء=مُقْفِرَة|قَفْرَة|قَفْر
القفراء=المُقْفِرَة|القَفْرَة|القَفْر
أقنية=قنوات
الاقنية=القنوات
مجباة=مجبية
المجباة=المجبية
مندبون=مندوبون|منتدبون
المندبون=المندوبون|المنتدبون
مندبين=مندوبين|منتدبين
المندبين=المندوبين|المنتدبين
مقفول=مقفل
المقفول=المقفل
موصود=موصد|مؤصد
طاقوي=طاقيّ
معكوف=معقوف
معكوفتان=معقوفتان
معكوفة=معقوفة
المعكوف=المعقوف
المعكوفتان=المعقوفتان
المعكوفة=المعقوفة
مشوار=طريق|مسار|نزهة
استبيان=استبانة
الاستبيان=الاستبانة
سواح=سياح
السواح=السياح
